+-+-+-+-+-+-+-+-+-+-+
|     |             |
+ +-+-+ +-+-+ +-+-+ +
| |     | |   |     |
+ + +-+-+ + +-+-+-+-+
| |   |   | |       |
+ +-+ +-+ + + +-+-+ +
|   |   | |   |     |
+ + +-+ + +-+-+ +-+-+
| | | | |     |   | |
+ + + + +-+-+ +-+-+ +
| |   |     |       |
+ +-+-+-+-+ + +-+ + +
|           |   | | |
+ +-+-+-+-+-+-+-+ +-+
|               |   |
+-+-+-+-+-+-+-+ + + +
| |     |     | | | |
+ + + +-+ +-+ + +-+ +
|   |       |       |
+-+-+-+-+-+-+-+-+-+-+